00020302010204020301
00020302010203020102
00030203020320121030
00022122321223212332
12341212121212122333
01020102030210100102
01233143102010201221
00201020201201023321
00102121212123312131
00102300212230031212
00004003203220102030
01001103123330020010
00101012222331201010
00110102223122201020
00101001415222101010