00000000000000000000
35551010100101015553
35551010100101015553
35551010100101015553
35551010100101015553
35551515155151515553
35550000000000005553
30022111101111122003
30020555055005552003
30020050050505552003
30020050055005502003
30023333033303332003
30021111000001112003
30000000011100000003
30000000014100000003