00000000000000000000
10101010100101010101
10101010100101010101
10001010100101010001
10101000300300010101
10101155355315510101
10100000000000000101
10111111101111111101
10000055505500555001
10101005005050555101
10101005005500500101
10101220333022033101
10101110000001011101
10000000011100000001
10111110014100111101