00301001100003100000
10000100000000000000
10001000555000111000
00100000055001300000
00000000055011300110
00000110011000300100
10100000000000000100
10335500000000000100
10115522202200220100
00000002002020221110
00000002002200200000
00100000111355310155
00000000000000000000
00000100011101003300
00300100014100003300