01020302010204020301
01020302010203020102
02030201020320121030
01022122321223212332
12321212121212122333
01020102030210100102
01232140102010201221
00201020201201023321
00102121212123312131
00102300212230011212
00001000203220102030
01001101123330020010
00101012222331201010
00110102223122201020
00101001012222101010